111111111111111111
11000000C000000001
100111111111C01111
1P011E000001000001
100C11111000C00111
111111111111111111
