111111111111111111111111111111111111111111111111111111111111111111
11110000C000000000000000000000000000000000000000000000000000000111
1111C0000000000000000000000000000000000000000000000000000000000001
1111E0011111111100000000000000000000000000000000000000000000000001
1111C0000000000000000000000000000000000000000000000000000000000001
111100000000000000000000000000000000000000000000000000000000000011
1111C0000000000000000000000000000000000000000000000000000000000001
111100000000000000000000000000000000000000000000000000000000000001
11110000000P000000000000000000000000000000000000000000000000000001
111111111111111111111111111111111111111111111111111111111111111111
